11111111111111111111111111111
1P000000000000000000011111001
10000010000000000000000000001
1C000000000000C00000000000001
10000000000000000000110000001
10000000000000000001110000001
10000000000000000000000000001
10C11111111110110000000000001
1111111C000000111111111011111
111111111111111111111110000E1
11111111111111111111111111111
