11111111111
1P1010101C1
11010101011
10101C10101
11C10101E11
11111111111
