1111111111
1000P00001
1111011111
1111011111
1C00C00E11
1111111111
