11111111111
1P0001000C1
10010001001
11001C11101
11C1011E001
11111111111
